Job ID: 2949384
Cluster: smp
User/Group: abc81/ling2340_2021s
State: COMPLETED (exit code 0)
Nodes: 1
Cores per node: 3
CPU Utilized: 00:00:09
CPU Efficiency: 30.00% of 00:00:30 core-walltime
Job Wall-clock time: 00:00:10
Memory Utilized: 1.15 MB
Memory Efficiency: 0.01% of 11.77 GB

['Radiolab', 'This American Life', 'Sawbones', 'This American Life', 'Move Your DNA', 'This American Life', 'This American Life', 'Wonderful', 'Radiolab', 'Bullseye with Jesse Thorn', 'Judge John Hodgman', 'One Bad Mother', 'Radiolab', 'This American Life', 'This American Life', 'Welcome to Nightvale', 'Radiolab', 'Welcome to Nightvale', 'Shmanners', 'This American Life', 'NeoScum', 'Welcome to Nightvale', 'This American Life', 'Radiolab', 'This American Life', 'Switchblade Sisters', 'NeoScum', 'This American Life', 'Radiolab', 'Welcome to Nightvale', 'Radiolab', 'One Bad Mother', 'This American Life', 'Friendly Fire', 'This American Life', 'This American Life', 'Friendly Fire', 'Friendly Fire', 'Welcome to Nightvale', 'The Adventure Zone', 'Welcome to Nightvale', 'The Flophouse', 'This American Life', 'This American Life', 'Welcome to Nightvale', 'Radiolab', 'Move Your DNA', 'Unlocking Us', 'Welcome to Nightvale', 'This American Life', 'This American Life', 'Welcome to Nightvale', 'Radiolab', 'This American Life', 'This American Life', 'This American Life', 'Radiolab', 'This American Life', 'Radiolab', 'Radiolab', 'Radiolab', 'Wonderful', 'This American Life', 'Sawbones', 'Wonderful', 'This American Life', 'This American Life', 'Move Your DNA', 'Shmanners', 'This American Life', 'Radiolab', 'This American Life', 'Move Your DNA', 'This American Life', 'Welcome to Nightvale', 'This American Life', 'This American Life', 'This American Life', 'This American Life', 'One Bad Mother', 'MBMBaM', 'Welcome to Nightvale', 'Welcome to Nightvale', 'This American Life', 'This American Life', 'This American Life', 'Bullseye with Jesse Thorn', 'Welcome to Nightvale', 'Radiolab', 'Radiolab', 'This American Life', 'Bullseye with Jesse Thorn', 'The Greatest Generation', 'Judge John Hodgman', 'This American Life', 'This American Life', 'NeoScum', 'Move Your DNA', 'This American Life', 'Shmanners', 'This American Life', 'Welcome to Nightvale', 'This American Life', 'MBMBaM', 'This American Life', 'Welcome to Nightvale', 'This American Life', 'This American Life', 'This American Life', "You're Wrong About", 'This American Life', 'This American Life', 'Move Your DNA', 'This American Life', 'Welcome to Nightvale', 'This American Life', 'This American Life', 'Welcome to Nightvale', 'The Flophouse', 'Radiolab', 'Judge John Hodgman', 'Welcome to Nightvale', 'The Greatest Generation', 'NeoScum', 'MBMBaM', 'This American Life', 'This American Life', 'Sawbones', 'Move Your DNA', 'This American Life', 'This American Life', 'Bullseye with Jesse Thorn', 'This American Life', 'The Greatest Generation', 'MBMBaM', 'Radiolab', 'Bullseye with Jesse Thorn', 'This American Life', 'Radiolab', 'Radiolab', 'Radiolab', 'Shmanners', 'Move Your DNA', 'This American Life', 'This American Life', 'Radiolab', 'Radiolab', 'The Greatest Generation', 'This American Life', 'Wonderful', 'This American Life', 'Move Your DNA', 'This American Life', 'One Bad Mother', 'Move Your DNA', 'This American Life', 'Radiolab', 'Friendly Fire', 'This American Life', 'This American Life', 'This American Life', 'This American Life', 'Bullseye with Jesse Thorn', 'This American Life', 'This American Life', 'Radiolab', 'Welcome to Nightvale', 'The Adventure Zone', 'This American Life', 'This American Life', 'Radiolab', 'This American Life', 'This American Life', 'Welcome to Nightvale', 'Move Your DNA', 'This American Life', 'This American Life', 'Move Your DNA', 'This American Life', 'This American Life', 'This American Life', 'This American Life', 'This American Life', 'This American Life', 'This American Life', 'The Flophouse', 'This American Life', 'This American Life', 'This American Life', 'Sawbones', 'Bullseye with Jesse Thorn', 'Bullseye with Jesse Thorn', 'Unlocking Us', 'This American Life', 'Move Your DNA', 'MBMBaM', 'Move Your DNA', 'This American Life', 'Wonderful', 'Welcome to Nightvale', 'This American Life', 'Radiolab', 'Welcome to Nightvale', 'Wonderful', 'Friendly Fire', 'Radiolab', 'This American Life', 'This American Life', 'The Adventure Zone', "You're Wrong About", 'This American Life', 'Move Your DNA', 'Switchblade Sisters', 'This American Life', 'This American Life', 'Radiolab', 'Welcome to Nightvale', 'This American Life', 'The Greatest Generation', 'This American Life', 'Sawbones', 'Judge John Hodgman', 'Radiolab', 'Radiolab', 'This American Life', 'Radiolab', 'Move Your DNA', 'This American Life', 'One Bad Mother', 'Radiolab', 'Radiolab', 'Welcome to Nightvale', 'This American Life', 'This American Life', 'This American Life', 'This American Life', 'This American Life', 'One Bad Mother', 'This American Life', 'This American Life', 'This American Life', 'This American Life', 'This American Life', 'This American Life', 'This American Life', 'This American Life', 'Bullseye with Jesse Thorn', 'Radiolab', 'The Greatest Generation', 'Radiolab', 'Bullseye with Jesse Thorn', 'This American Life', 'Welcome to Nightvale', 'Move Your DNA', 'Friendly Fire', 'Welcome to Nightvale', 'This American Life', 'Judge John Hodgman', 'This American Life', 'Move Your DNA', 'Welcome to Nightvale', 'This American Life', 'Move Your DNA', 'This American Life', 'This American Life', 'This American Life', 'This American Life', 'This American Life', 'This American Life', 'Switchblade Sisters', 'This American Life', 'This American Life', 'Bullseye with Jesse Thorn', 'This American Life', 'This American Life', 'This American Life', 'Move Your DNA', 'This American Life', 'Welcome to Nightvale', 'This American Life', 'This American Life', 'Radiolab', 'This American Life', 'This American Life', 'This American Life', 'Judge John Hodgman', 'This American Life', 'The Adventure Zone', 'Welcome to Nightvale', 'This American Life', 'This American Life', 'This American Life', 'This American Life', 'This American Life', 'MBMBaM', 'This American Life', 'Bullseye with Jesse Thorn', 'Move Your DNA', 'This American Life', 'Welcome to Nightvale', 'Welcome to Nightvale', 'This American Life', 'Welcome to Nightvale', 'Shmanners', 'This American Life', 'This American Life', 'Welcome to Nightvale', 'Bullseye with Jesse Thorn', 'This American Life', 'This American Life', 'Sawbones', 'Welcome to Nightvale', 'This American Life', 'This American Life', 'Radiolab', 'This American Life', 'This American Life']

['Radiolab', 'This American Life', 'Sawbones', 'This American Life', 'Move Your DNA', 'This American Life', 'This American Life', 'Wonderful', 'Radiolab', 'Bullseye with Jesse Thorn', 'Judge John Hodgman', 'One Bad Mother', 'Radiolab', 'This American Life', 'This American Life', 'Welcome to Nightvale', 'Radiolab', 'Welcome to Nightvale', 'Shmanners', 'This American Life', 'NeoScum', 'Welcome to Nightvale', 'This American Life', 'Radiolab', 'This American Life', 'Switchblade Sisters', 'NeoScum', 'This American Life', 'Radiolab', 'Welcome to Nightvale', 'Radiolab', 'One Bad Mother', 'This American Life', 'Friendly Fire', 'This American Life', 'This American Life', 'Friendly Fire', 'Friendly Fire', 'Welcome to Nightvale', 'The Adventure Zone', 'Welcome to Nightvale', 'The Flophouse', 'This American Life', 'This American Life', 'Welcome to Nightvale', 'Radiolab', 'Move Your DNA', 'Unlocking Us', 'Welcome to Nightvale', 'This American Life', 'This American Life', 'Welcome to Nightvale', 'Radiolab', 'This American Life', 'This American Life', 'This American Life', 'Radiolab', 'This American Life', 'Radiolab', 'Radiolab', 'Radiolab', 'Wonderful', 'This American Life', 'Sawbones', 'Wonderful', 'This American Life', 'This American Life', 'Move Your DNA', 'Shmanners', 'This American Life', 'Radiolab', 'This American Life', 'Move Your DNA', 'This American Life', 'Welcome to Nightvale', 'This American Life', 'This American Life', 'This American Life', 'This American Life', 'One Bad Mother', 'MBMBaM', 'Welcome to Nightvale', 'Welcome to Nightvale', 'This American Life', 'This American Life', 'This American Life', 'Bullseye with Jesse Thorn', 'Welcome to Nightvale', 'Radiolab', 'Radiolab', 'This American Life', 'Bullseye with Jesse Thorn', 'The Greatest Generation', 'Judge John Hodgman', 'This American Life', 'This American Life', 'NeoScum', 'Move Your DNA', 'This American Life', 'Shmanners', 'This American Life', 'Welcome to Nightvale', 'This American Life', 'MBMBaM', 'This American Life', 'Welcome to Nightvale', 'This American Life', 'This American Life', 'This American Life', "You're Wrong About", 'This American Life', 'This American Life', 'Move Your DNA', 'This American Life', 'Welcome to Nightvale', 'This American Life', 'This American Life', 'Welcome to Nightvale', 'The Flophouse', 'Radiolab', 'Judge John Hodgman', 'Welcome to Nightvale', 'The Greatest Generation', 'NeoScum', 'MBMBaM', 'This American Life', 'This American Life', 'Sawbones', 'Move Your DNA', 'This American Life', 'This American Life', 'Bullseye with Jesse Thorn', 'This American Life', 'The Greatest Generation', 'MBMBaM', 'Radiolab', 'Bullseye with Jesse Thorn', 'This American Life', 'Radiolab', 'Radiolab', 'Radiolab', 'Shmanners', 'Move Your DNA', 'This American Life', 'This American Life', 'Radiolab', 'Radiolab', 'The Greatest Generation', 'This American Life', 'Wonderful', 'This American Life', 'Move Your DNA', 'This American Life', 'One Bad Mother', 'Move Your DNA', 'This American Life', 'Radiolab', 'Friendly Fire', 'This American Life', 'This American Life', 'This American Life', 'This American Life', 'Bullseye with Jesse Thorn', 'This American Life', 'This American Life', 'Radiolab', 'Welcome to Nightvale', 'The Adventure Zone', 'This American Life', 'This American Life', 'Radiolab', 'This American Life', 'This American Life', 'Welcome to Nightvale', 'Move Your DNA', 'This American Life', 'This American Life', 'Move Your DNA', 'This American Life', 'This American Life', 'This American Life', 'This American Life', 'This American Life', 'This American Life', 'This American Life', 'The Flophouse', 'This American Life', 'This American Life', 'This American Life', 'Sawbones', 'Bullseye with Jesse Thorn', 'Bullseye with Jesse Thorn', 'Unlocking Us', 'This American Life', 'Move Your DNA', 'MBMBaM', 'Move Your DNA', 'This American Life', 'Wonderful', 'Welcome to Nightvale', 'This American Life', 'Radiolab', 'Welcome to Nightvale', 'Wonderful', 'Friendly Fire', 'Radiolab', 'This American Life', 'This American Life', 'The Adventure Zone', "You're Wrong About", 'This American Life', 'Move Your DNA', 'Switchblade Sisters', 'This American Life', 'This American Life', 'Radiolab', 'Welcome to Nightvale', 'This American Life', 'The Greatest Generation', 'This American Life', 'Sawbones', 'Judge John Hodgman', 'Radiolab', 'Radiolab', 'This American Life', 'Radiolab', 'Move Your DNA', 'This American Life', 'One Bad Mother', 'Radiolab', 'Radiolab', 'Welcome to Nightvale', 'This American Life', 'This American Life', 'This American Life', 'This American Life', 'This American Life', 'One Bad Mother', 'This American Life', 'This American Life', 'This American Life', 'This American Life', 'This American Life', 'This American Life', 'This American Life', 'This American Life', 'Bullseye with Jesse Thorn', 'Radiolab', 'The Greatest Generation', 'Radiolab', 'Bullseye with Jesse Thorn', 'This American Life', 'Welcome to Nightvale', 'Move Your DNA', 'Friendly Fire', 'Welcome to Nightvale', 'This American Life', 'Judge John Hodgman', 'This American Life', 'Move Your DNA', 'Welcome to Nightvale', 'This American Life', 'Move Your DNA', 'This American Life', 'This American Life', 'This American Life', 'This American Life', 'This American Life', 'This American Life', 'Switchblade Sisters', 'This American Life', 'This American Life', 'Bullseye with Jesse Thorn', 'This American Life', 'This American Life', 'This American Life', 'Move Your DNA', 'This American Life', 'Welcome to Nightvale', 'This American Life', 'This American Life', 'Radiolab', 'This American Life', 'This American Life', 'This American Life', 'Judge John Hodgman', 'This American Life', 'The Adventure Zone', 'Welcome to Nightvale', 'This American Life', 'This American Life', 'This American Life', 'This American Life', 'This American Life', 'MBMBaM', 'This American Life', 'Bullseye with Jesse Thorn', 'Move Your DNA', 'This American Life', 'Welcome to Nightvale', 'Welcome to Nightvale', 'This American Life', 'Welcome to Nightvale', 'Shmanners', 'This American Life', 'This American Life', 'Welcome to Nightvale', 'Bullseye with Jesse Thorn', 'This American Life', 'This American Life', 'Sawbones', 'Welcome to Nightvale', 'This American Life', 'This American Life', 'Radiolab', 'This American Life', 'This American Life']
Most Informative Features:
Bullseye with Jesse Thorn: did, promo, time, wanna, mean, gonna, people, chuckles, yeah, laughs, jordan, really, kind, think, fades, just, music, like, know, jesse
Friendly Fire: guy, laugh, music, really, know, right, clip, gonna, think, just, war, yeah, film, laughs, movie, like, john, ben, adam, host
Judge John Hodgman: wanna, joel, think, mm, quietly, right, laughter, gonna, hm, don, uh, just, judge, know, laugh, yeah, like, laughs, jesse, john
MBMBaM: good, got, wanna, laughing, right, think, oh, um, know, fucking, gonna, just, okay, uh, yeah, laughs, like, justin, griffin, travis
Move Your DNA: don, lot, kind, way, things, stephanie, time, body, going, yeah, people, really, right, think, know, movement, just, like, dani, katy
NeoScum: gonna, right, laughs, got, going, oh, guys, like, okay, just, tech, yeah, mm, dak, dr, es, tw, ct, bb, gr
One Bad Mother: wanna, time, music, okay, job, good, host, think, doing, right, know, really, yeah, crosstalk, gonna, just, like, laughs, theresa, biz
Radiolab: pat, annie, radiolab, right, matt, okay, people, speaker, clip, yeah, simon, know, krulwich, latif, just, molly, like, abumrad, robert, jad
Sawbones: say, things, mean, really, medical, lot, gonna, right, yeah, think, okay, uh, people, just, um, know, laughs, like, justin, sydnee
Shmanners: lot, hmm, thing, oh, say, people, yes, gonna, think, just, yeah, know, uh, laughs, right, um, okay, like, travis, teresa
Switchblade Sisters: kelly, way, people, laughs, speaker, music, gonna, quote, really, yeah, movie, kind, think, uh, just, film, know, like, um, april
The Adventure Zone: mean, ve, right, kind, oh, think, um, gonna, just, laughs, know, yeah, like, okay, uh, justin, clint, griffin, travis, fitzroy
The Flophouse: justin, think, know, okay, people, laughter, uh, gonna, multiple, audience, just, laugh, yeah, movie, crosstalk, laughs, like, dan, stuart, elliott
The Greatest Generation: scene, really, mm, make, just, gonna, think, know, right, episode, promo, music, uh, laughs, yeah, clip, like, ben, adam, host
This American Life: act, way, did, say, right, got, ve, really, time, didn, think, said, going, don, know, people, just, glass, like, ira
Unlocking Us: julie, way, book, right, time, black, love, said, want, yeah, white, really, say, going, know, think, just, people, like, bb
Welcome to Nightvale: new, station, police, dana, old, secret, did, city, good, mayor, town, time, listeners, know, said, just, like, cecil, night, vale
Wonderful: right, good, sort, thing, oh, gonna, kind, okay, lot, really, um, think, know, just, yeah, laughs, uh, like, rachel, griffin
You're Wrong About: movie, okay, right, thing, time, kind, sort, really, going, don, think, yeah, know, people, just, michael, marshall, mike, sarah, like
